"PAR - TanzaniaN"	african_leopard
"PAR - TanzaniaW"	african_leopard
"NIM - Arabian1"	arabian_leopard
"NIM - Arabian2"	arabian_leopard
"PAR - Ghana"	african_leopard
"FUS - India"	asian_leopard
"TUL - Afghanistan"	asian_leopard
"PAR - Cameroon"	african_leopard
"PAR - Etiopia"	african_leopard
"MEL - Java"	asian_leopard
"ORI - Korea"	asian_leopard
"PAR - Morocco"	african_leopard
"FUS - Nepal"	asian_leopard
"TUL - Palestine"	asian_leopard
"PAR - South Africa"	african_leopard
"KOT - Srilanka"	asian_leopard
"DEL - Vietnam"	asian_leopard
"PAR - Namibia"	african_leopard
"ORI - Zoo"	asian_leopard
"ORI - Amur"	asian_leopard
